CAN - N A C
ALL - L A L
MAT - A M T
FAT - A T F
CUP - P C U
CAP - A P C
SUN - U N S
FAN - A F N
COW - O C W
THE - E T H
FOR - R O F
EGG - G E G
AND - D A N
JUG - U G J
RUN - N R U 
GUN - U N G
GUM - M U G 
ZIP - I Z P
INK - K I N
AXE - A E X
RED - E R D
EYE - Y E E
LIE - I E L
LID - D I L
FIN - I F N


FISH - SFHI
RAIN - INAR 
RAIL - LIAR
BALL - LALB
GAME - MEGA
GATE - TAEG 
JUNE - UJEN
JULY - YJLU
MANY - NMYA
BIRO - RIBO
BOMB - OMBB
BLUE - UELB
PINK - NIPK
WILL - LILW
HEAD - ADEH
HAND - DNAH
MADE - ADEM
MILK - KILM
FOOD - ODOF
NEED - EEDN
RICE - ERIC 
MALT - TALM
SKIN - ISKN
LEFT - FELT
LIFE - IFEL
LICK - ICKL
LICE - ILEC
LEVY - YVLE
KING - GNKI
AXIS - XISA



SHEEP - EPEHS
ANNEX - NXNEA
HOUSE - SUHOE
MANGO - NOGMA
BOARD - R D A O B
SNACK - NKCSA
MUMMY - YUMMM
UNCLE - ELUCN
APPLE - 
AUNTY -
JUDGE -
WHALE -
BLACK -
BROWN -
DAVID -
DADDY -
FAITH -
SOCKS -
GREEN -
JESUS -
LEMON - 
LEVER - 
QUEEN - 
COUNT - 
COURT - 
TOTAL - 
PRINT - 
PARTY - 
ALIEN - 
ALIKE - 
AVOID - 
AWARE - 
BOAST - 
BONUS - 
BLUSH - 
EXPEL - 
GRAIN - 
BEANS - 
CHAOS - 
GRAPH - 
KNACK - 




